a	
able	（〜）できる
about	（〜に）関する
above	（〜の）上に
accept	受け入れる
according (to)	（〜に）よれば
account	会計
accuse	訴える
achieve	達成する
across	横断して
act	行う／行為
adapt	適応させる
add	加える
admit	承認する
adult	大人
advertisement	広告
advise	勧める、助言する
affect	影響する
afraid	恐れる
after	後に
again	再び
against	反対する
age	年齢
agency	代理店
ago	前に
agree	賛成する
ahead	先に
aid	援助／援助する
aim	狙い
air	空気
alive	生きている
all	すべての
allow	許す
ally	味方、同盟
almost	ほとんど
alone	独り
along	（〜に）沿って
already	すでに
also	また
although	けれども
always	いつも
among	の中に
amount	統計
and	（〜）と
anger	怒り
angle	角度
announce	発表する
another	ほかの、もう１つの
answer	返事／答える
any	いくらか
apartment	アパート
apologize	謝る
appeal	懇願する
appear	現れる
apple	リンゴ
apply	適用する
appoint	指名する
approve	認める
area	地域
argue	論じる
arm	腕
army	軍隊
around	周辺
arrest	逮捕する
arrive	着く
art	美術
as	（〜の）ように
ask	尋ねる、頼む
assist	手伝う
at	に、で
attach	貼り付ける
attack	攻撃する
attempt	試みる
attend	出席する
attention	注意
authority	権威
automatic	自動的な
autumn	秋
available	利用できる
average	平均
avoid	避ける
awake	目が覚める
award	与えた
away	離れた
baby	赤ちゃん
back	背中／後ろの
bad	悪い
bag	袋
balance	平行
ball	球
ballot	一票
ban	禁止する
bank	銀行
bar	酒場
barrier	障壁
base	土台、基地
basket	かご
bath	入浴
battle	戦い
be	ある、いる
bear	耐える
beat	打つ
beauty	美しさ
because	なぜなら
become	（〜に）なる
bed	ベッド
beer	ビール
before	前に
begin	始める
behind	後ろに
believe	信じる
bell	ベル
belong	（〜に）属する
below	下に
bend	曲げる
beside	そばに
best	最もよい
betray	裏切る
better	よりよい
between	（〜の）間に
big	大きい
bill	請求書
bird	鳥
birth	誕生
bit	少し
bite	かむ
black	黒
blade	刃
blame	非難する
blank	空白
blanket	毛布
bleed	出血する
blind	盲目
block	塊／妨げる
blood	血
blow	殴打／吹く
blue	青い
board	板
boat	船
body	体
bomb	爆弾
bone	骨
bonus	ボーナス
book	本
boot	長靴
border	境
born	生まれた
borrow	借りる
boss	上司
both	両方
bottle	瓶
bottom	底
box	箱
boy	男の子
boycott	排斥する
brain	脳
brake	ブレーキ
branch	枝
brave	勇敢な
bread	パン
break	壊す／休憩
breathe	呼吸する
brick	れんが
bridge	橋
brief	短時間
bright	明るい
bring	持ってくる
broad	広い
broadcast	放送
brother	兄弟
brown	茶色
brush	ブラシ
budget	予算
build	建てる
bullet	弾丸
burn	燃える
burst	破裂する
bury	埋める
business	職業、商売
busy	忙しい
but	が、しかし
butter	バター
button	ボタン
buy	買う
by	（〜の）近くに、（〜に）よって
cabinet	内閣、戸棚
call	呼ぶ
calm	静かな
camera	カメラ
camp	キャンプ
campaign	キャンペーン
can	できる
cancel	取り消す
capture	捕らえる
car	車
card	カード
care	世話
carriage	客車
carry	運ぶ
case	場合
cash	現金
cat	猫
catch	つかむ
cause	原因
celebrate	祝う
cell	細胞
center	中心
century	世紀
ceremony	式
certain	確かな
chain	鎖
chair	いす
chairman	議長
challenge	挑戦
champion	チャンピョン
chance	機会
change	変化
channel	チャンネル
character	性格
charge	請求する
chart	図表
chase	追跡する
cheap	安い
check	調査する
cheer	応援する
cheese	チーズ
chemical	化学製品／化学の
chest	胸
chief	長官
child	子供
choose	選ぶ
church	教会
circle	円
citizen	公民
city	都市
civilian	民間人
claim	要求する
clash	衝突する
class	授業
clean	清潔な
clear	透明な、明確な
climate	気候
climb	上る
clock	時計
close	近い
cloth	布
cloud	雲
coal	石炭
coast	海岸
coat	上着
code	暗号
cold	寒い
collect	集める
college	大学
colony	植民地
color	色
combine	結合する
come	来る
comfort	慰める
command	命令する
comment	論評する
committee	委員会
common	共通の、普通の
communicate	伝達する
community	コミュニティ
company	会社
compare	比較する
compete	競争する
complete	完成する
compromise	妥協
computer	コンピュータ
concern	（〜に）関連する
condemn	非難する
condition	条件
conference	会議
confirm	確認する
congratulate	祝う
congress	国会
connect	つなぐ
consider	熟慮する
consumption	消費
contact	接触
contain	含む
continent	大陸
continue	続く
control	支配する
cook	料理する
cool	涼しい
cooperate	協力する
copy	写す
cork	コルク
corn	トウモロコシ
corner	隅
correct	直す
cost	費用
cotton	綿
count	数える
country	国
course	方向
court	裁判所
cover	覆う
cow	牛
crash	ぶつかる
create	創る
credit	クレジット、信用
crew	乗組員
crime	犯罪
crisis	危機
criteria	基準
criticize	批判する
crop	作物
cross	渡る
crowd	群衆
crush	押し潰す
cry	泣く
culture	文化
cup	カップ
cure	治療する
current	現在の
custom	習慣
cut	切る
damage	障害
dance	踊る
danger	危険
dark	暗い
date	日付
daughter	娘
day	日
dead	死んでいる
deaf	耳が聞こえない
deal	取引する
dear	拝啓
debate	論じる
debt	借金
decide	決める
declare	宣言する
decrease	減らす
deep	深い
defeat	敗北
defend	防御する
define	定義する
degree	程度
delay	延期する
delicate	壊れやすい
deliver	届ける
demand	要求する
demonstrate	証明する
denounce	公然と非難する
deny	否定する
departure	出発
depend	頼る
deploy	配置する
depression	憂鬱
describe	形容する
desert	砂漠
design	図案を作る
desire	望む
destroy	破壊する
detail	細部
develop	開発する
device	機器
die	死ぬ
diet	常食、ダイエット
differ	異なる
difficult	難しい
dig	掘る
dinner	夕食
diplomat	外交官
direct	直接の
dirt	汚れ
disappear	消える
discover	発見する
discuss	論じる
disease	病気
disk	ディスク
dismiss	解散させる、解雇する
dispute	論争する
distance	距離
divide	分ける
do	する
doctor	医者
document	文書
dog	犬
door	戸
doubt	疑う
down	下に
drain	排出させる
draw	描く
dream	夢を見る
dress	ドレス
drink	飲む
drive	運転する
drop	落とす
drug	薬
dry	乾いた
during	（〜の）間
dust	ホコリ
duty	義務
each	それぞれの
ear	耳
early	早い
earn	稼ぐ
earth	地球
east	東
easy	簡単
eat	食べる
edge	縁
education	教育
effect	結果
effort	努力
egg	卵
either	どちらの
elastic	ゴム／弾性の
electricity	電気
element	成分
else	ほかの
embassy	大使館
emergency	緊急
emotion	感情
employ	雇う
empty	空の
end	終わり
enemy	敵
enforce	施行する
engine	エンジン
enjoy	楽しむ
enough	十分な
enter	入る
entertain	楽しませる
environment	環境
equal	平等な
equate	（〜と）同等に扱う
equipment	装備
erase	消す
escape	逃亡する
especially	特に
establish	設立する
estimate	見積もる
ethnic	民族的
evaporate	気化する
even	均等の
event	行事
ever	いつも
every	すべての
evidence	証拠
evil	邪悪な
exact	正確な
example	例
except	（〜を）除いて
exchange	交換する
excuse	言い訳
execute	実行する
exercise	運動する
exist	存在する
exist	出口
expand	拡張する
expect	予期する
expense	費用
experience	経験
experiment	実験
expert	専門家
explain	説明する
explode	爆発する
explore	探索する
export	輸出する
express	示す
extend	拡張する
extra	余分
extreme	極端な
eye	目
face	顔
fact	事実
factory	工場
fail	失敗する
fair	公正な
fall	転ぶ、落ちる
false	誤った
family	家族
famous	有名な
far	遠い
fast	速い
fat	太った
father	父親
fear	恐怖
feather	羽毛
feature	特徴
feed	食物を与える
feel	感じる
female	女／メスの
fertile	多産な
few	少ない
field	畑、分野
fierce	激しい
fight	戦う
figure	姿
file	ファイル
fill	満たす
film	映画
final	最後の
finance	財政
find	見つける
fine	細かい
finger	指
finish	終わる
fire	火
firm	安定した
first	最初
fish	魚
fist	拳
fit	ふさわしい
fix	直す
flag	旗
flat	平らな
float	浮かぶ
floor	床
flow	流れ
flower	花
fluid	液体
fly	飛ぶ
fog	霧
fold	折る
follow	ついていく
food	食べ物
fool	ばか
foot	足
for	（〜に）向かって、（〜の）ために
forbid	禁じる
force	力
foreign	外国の
forest	森林
forget	忘れる
forgive	許す
form	形
former	前の
forward	前方へ
frame	枠
free	無料
freeze	凍る
fresh	目新しい
friend	友達
frighten	おびえさせる
from	（〜）から
front	先の
fruit	果物
fuel	燃料
full	満ちた
fun	楽しい
future	将来
gain	手に入れる
gallon	ガロン
game	遊び
gang	群れ、暴力団
garden	庭
gas	ガス
gather	集める
general	一般の
gentle	優しい
get	受け取る
gift	贈り物
girl	女の子
give	与える
glass	ガラス
global	全世界の
go	行く
goal	目的
god	神
gold	金
good	よい
govern	統治する
grass	草
gray	灰色
great	巨大な
green	緑
ground	土地
group	集団
grow	成長する
guarantee	保証
guard	守る
guess	推測する
guide	案内する
guilty	有罪
gun	鉄砲
guy	男、やつ
hair	毛
half	半分
halt	止まる
hand	手
hang	掛ける
happen	起こる
happy	うれしい
hard	硬い
harm	危害を加える
hat	帽子
hate	憎む
have	持つ
he	彼
head	頭
heal	治す
health	健康
hear	聞く
heart	心臓
heat	熱
heavy	重い
help	助ける
her	彼女の
here	ここ
hide	隠す
high	高い
hijack	（飛行機などを）乗っ取る
hill	丘
him	彼に
hire	雇う
his	彼の
history	歴史
hit	打つ
hold	穴
holiday	休暇
hollow	うつろの
holy	神聖な
home	家
honest	正直な
hope	（〜と）願う
horrible	恐ろしい
horse	馬
hospital	病院
hostage	人質
hostile	敵意を持った
hot	暑い
hour	時間
house	家
how	どのように、どれほど
however	しかしながら
huge	巨大な
human	人間
humor	ユーモア
hunger	飢餓
hunt	狩る
hurry	急ぐ
hurt	傷つける
husband	夫
I	私
ice	氷
idea	発想
identify	（同一のものであると）確認する
if	もし
ill	病気
imagine	想像する
import	輸入
important	大事な
improve	改善する
in	（〜の）中に［へ］
inch	インチ
incident	事件
include	含む
increase	増大する
independent	独立した
indicate	示す
individual	個人
industry	工業
infect	感染させる
influence	影響を与える
inform	知らせる
inject	注射する
injure	傷つける
innocent	無罪の
insane	狂気の
insect	虫
inspect	検査する
instead	その代わりに
insult	侮辱する
insurance	保険
intelligence	知能
intense	猛烈な
interest	興味
interfere	干渉する
international	国際的な
into	（〜の）中に［へ］
invade	侵略する
invent	発明する
invest	投資する
investigate	調査する
invite	招待する
involve	関係させる
iron	鉄
island	島
issue	発行する
it	それ
item	項目、種目
jacket	ジャケット
jail	刑務所
jewel	宝石
job	仕事
join	結合する
joint	合わせ目
joke	冗談
joy	喜び
judge	裁判官
jump	跳ぶ
jury	陪審（員）
just	公正な
keep	保つ
key	鍵
kick	蹴る
kid	（〜を）からかう
kill	殺す
kind	種類
king	王
kiss	キスする
kit	ーそろい
kitchen	台所
knife	ナイフ
know	知る
labor	労働
laboratory	研究所
lack	欠く
lake	湖
land	陸地
language	言葉
large	大きい
last	最後の
late	遅い
laugh	笑う
law	法律
lay	置く
lead	導く
leak	漏れる
learn	学ぶ
least	最小の
leave	去る
left	左
leg	脚
legal	合法的
lend	貸す
length	長さ
less	より少ない
let	（〜に〜を）許す
letter	手紙
level	程度
lie	嘘／横たわる
life	命
lift	上げる
light	光
like	好む
limit	限界
line	線
link	つなぐ
lip	唇
liquid	液体
list	目録
listen	聴く
little	小さい
live	生きる
load	積む
loan	貸付金
local	現地の
locate	位置させる
lock	錠
log	記録
lone	独りの
long	長い
look	見る
loose	緩い
lose	失う、負ける
lot	たくさん
loud	うるさい
love	愛
low	低い
luck	運
magic	魔法
mail	郵便
main	主要な
major	大きいほうの
make	作る
male	男／オスの
man	男
manufacture	製作
many	たくさんの
map	地図
march	行進する
mark	印
market	市場
marry	結婚する
master	征服する／習得する
match	試合
material	材料
matter	物質
may	（〜）かもしれない
mayor	市長
me	私に
meal	食事
mean	意味する
measure	計る、測る
meat	肉
media	メディア、媒体
meet	会う
member	一員
memory	記憶
mental	精神の
mercy	慈悲
message	伝言
metal	金属
meter	メートル
method	方法
middle	真ん中
might	権力／（〜）かもしれない
mile	マイル
military	軍隊
milk	牛乳
mind	精神
mine	私のもの、鉱山、地雷
minister	大臣
minor	小さいほうの
miscellaneous	種々雑多な（ものから成る）
miss	失敗／寂しく思う
mistake	誤り
mix	混ぜる
mob	暴徒
model	手本
moderate	穏健な、適度の
modern	現代的な
money	カネ
month	（暦の）月
moon	月
moral	道徳
more	より多く
morning	朝
most	最も
mother	母親
motion	動き
mountain	山
mouth	口
move	動く、引っ越す
much	たくさんの
murder	殺人
muscle	筋肉
music	音楽
must	（〜）すべきである
my	私の
mystery	神秘
nail	くぎ、爪
name	名前
narrow	狭い
nation	国家
native	出生地の
navy	海軍
near	近い
necessary	必要な
neck	首
need	（〜）する必要がある
neighbor	隣人
neither	（AもBも〜）ない
nerve	神経
neutral	中立、中性
never	一度も〜ない
new	新しい
news	消息、ニュース
next	次の
nice	よい、愉快な
night	夜
no	いいえ
noise	音、雑音
noon	正午
normal	普通の／標準
north	北
nose	鼻
not	（〜で）ない
note	ノート
nothing	何も（〜）ない
notice	気づく
now	今
nowhere	どこにも［どこへも］、（〜）ない
number	数字
obey	従う
object	対象／反対する
observe	観察する
occupy	占領する
occur	起こる
of	（〜）の
off	離れて、外れて
offensive	侮辱的な／攻撃
offer	提供する
office	事務室
officer	将校、役人
often	たびたび
oil	石油、油
old	古い
on	（〜の）上
once	一度
only	ただ（〜）だけ
open	開く
operate	操作する、手術する
opinion	意見
opportunity	機会
opposite	反対の
oppress	圧迫する
or	あるいは
order	命令、順番
organize	組織する
other	ほかの
ounce	オンス
our	私たちの
ours	私たちのもの
oust	追い払う
out	外
over	の上／終わる
owe	借りがある
own	自分の
page	ページ
pain	痛み
paint	ペンキを塗る
pan	浅鍋
pants	ズボン、パンツ
paper	紙
parade	行列
parcel	小荷物
parent	親
parliament	国会
part	部分
party	パーティ、政党
pass	通る、合格する
passenger	乗客
past	過去
paste	貼り付ける
path	小道、方向
patient	患者
pattern	柄
pay	払う
peace	平和
pen	ペン
pencil	鉛筆
people	人々
percent	パーセント
perfect	完全な
perform	演じる
perhaps	たぶん
period	期間
permanent	永遠の
permit	許す
person	人
physical	身体の
pick	選ぶ
picture	絵
piece	一個、一片
pig	豚
pilot	パイロット
pint	パイント（液量単位）
pipe	管
place	場所
plain	明白な、簡素な
plan	計画
plane	飛行機
plant	植物
plastic	プラスチック
plate	皿
play	弾く、遊ぶ／劇
please	どうぞ／喜ばせる
plenty	十分な
pocket	ポケット
point	点
poison	毒
policy	方針
politics	政治
pollute	汚染する
poor	貧しい
popular	人気がある
port	港
position	位置、立場
possess	所有する
possible	可能
postpone	延期する
potato	ジャガイモ
pound	ポンド
pour	流す
powder	粉
power	力
practice	練習する
praise	褒める
pray	祈る
pregnant	妊娠している
present	現在／与える
press	押す
pretty	きれいな
prevent	防ぐ
price	値段
print	印刷する
prison	刑務所
private	個人的な
prize	賞
problem	問題
process	過程
product	商品
professor	教授
profit	利益
program	プログラム
progress	進行
project	計画
property	財産
propose	提案する
protect	守る
protest	異議
prove	証明する
provide	提供する
public	公共
publish	出版する
pull	引く
punish	処罰する
purchase	購入する
pure	純粋な
purpose	目的
push	押す
put	置く
quality	質
quart	クオート
quarter	４分の１
queen	女王
question	質問
quick	速い
quiet	静かな
quit	辞める
quite	実に、かなり
race	レース
radiation	放射
raid	襲撃
rail	鉄道
rain	雨
raise	持ち上げる
range	範囲
rare	珍しい
rate	程度、料金
rather	多少／むしろ
ray	光線
reach	届く
react	反応する
read	読む
ready	用意ができた
real	本物
reason	理由、理性
receive	得る
recognize	見分ける、認識する
record	記録、レコード
recover	回復する
red	赤い
reduce	減らす
refugee	難民
refuse	拒否する
regret	後悔する
regular	通常の、規則的な
reject	断る
relation	関係
release	放す
remain	残る
remember	覚える
remove	取り除く
repair	修理する
repeat	繰り返し言う
report	報告
represent	代表する
request	頼む
require	要する
rescue	救助する
research	研究
resign	引退する
resist	抵抗する
resolution	決意
resource	資源
respect	尊敬する
responsible	責任がある
rest	休憩する／残り
restrain	抑える
result	結果
retire	引退する
return	戻る
revolt	反抗する
reward	報酬
rice	コメ
rich	金持ちの
ride	乗る
right	右、権利
ring	指輪
riot	暴動
rise	上がる、高まる
risk	危険
river	川
road	道
rob	奪う
rock	岩
rocket	ロケット
roll	転がる
roof	屋根
room	部屋
root	根
rope	縄
rough	粗い
round	丸い
row	列／船をこぐ
rub	こする
rubber	ゴム
ruin	破壊する
rule	規則／支配する
run	走る
sad	悲しい
safe	安全
sail	帆／航海する
salt	塩
same	同じ
sand	砂
satisfy	満足させる
save	救う
say	言う
scale	規模、うろこ
scare	おびえさせる
school	学校
science	科学
score	得点
script	脚本
sea	海
search	探す
season	季節
seat	席
second	第二の／秒
secret	秘密
section	課
security	安全
see	見る
seed	種子
seek	探す
seem	見える、思われる
seize	つかむ
seldom	めったに（〜ない）
self	自己
sell	売る
senate	議会、上院
send	送る
sense	感覚
sentence	文
separate	引き離す／別個の
series	連続
serious	まじめな、真剣な
serve	仕える
set	置く
settle	落ち着かせる、決着する
several	いくつかの
severe	厳しい
sex	性別、セックス
shade	陰
shake	揺れる
shall	（〜）でしょう、だろう
shame	恥ずかしさ
shape	形
share	分配する
sharp	鋭い
she	彼女
sheet	シーツ、１枚の（〜）
shelf	棚
shell	殻
shelter	保護する
shine	光る
ship	船
shirt	シャツ
shock	ショック
shoe	靴
shoot	撃つ
shop	店
short	短い
should	（〜）べきである
shout	叫ぶ
show	見せる／ショー
shrink	縮む
shut	閉じる
sick	病気の
side	側、面
sign	合図、しるし
signal	信号
silence	静けさ
silk	絹
silver	銀
similar	類似した
simple	単純な
since	（〜）以来
sing	歌う
single	単独
sister	姉、妹
sit	座る
situation	状況
size	大きさ
skill	技術
skin	皮膚
skirt	スカート
sky	空
slave	奴隷
sleep	眠る
slide	横滑りする
slip	滑る
slow	遅い
small	小さい
smart	賢い
smash	粉砕する
smell	におい
smile	微笑する
smoke	煙／たばこを吸う
smooth	滑らか
snack	軽食、おやつ
snake	蛇
sneeze	くしゃみする
snow	雪
so	だから／とても
soap	せっけん
social	社会の
society	社会
soft	柔らかい
soil	土
soldier	兵士
solid	固形の
solve	解く
some	多少の
son	息子
song	歌
soon	もうすぐ
sorry	後悔して、残念に思って
sort	種類
soul	魂
sound	音
south	南
space	宇宙、空間
speak	話す
special	特別な
speech	話すこと、スピーチ
speed	速度
spell	つづる
spend	使う、過ごす
spirit	精神
spot	しみ／見つける
spread	塗る、広げる
spring	春、ばね、泉
spy	スパイ
square	正方形
stage	舞台
stairs	階段
stamp	切手
stand	立つ
star	星
start	始まる
starve	飢える
state	状態、国家／述べる
station	駅、局
status	地位
stay	泊まる、滞在する
steal	盗む
steam	蒸気
steel	鋼鉄
step	一歩
stick	棒
still	動きがない
stomach	胃
stone	石
stop	停止する
store	店／蓄える
storm	嵐
story	物語
straight	真っすぐ
strange	奇妙な
stream	小川、流れ
street	街路
stretch	伸ばす、張る
strike	たたく、ぶつかる
string	糸
strong	強い
structure	構造
struggle	争う、もがく
study	勉強する
stupid	愚かな
subject	主題
substance	物質
substitute	代用する
succeed	成功する
such	（〜の）ような
sudden	突然の
suffer	苦しむ
sugar	砂糖
suggest	提案する
suit	スーツ／合う
summer	夏
sun	太陽
supervise	監督する
supply	供給する
support	支援する
suppose	仮定する
suppress	鎮圧する
sure	確信する
surface	表面
surprise	驚かす
surround	囲む
survive	生き残る
suspect	疑う
suspend	延期する
swallow	飲み込む
swear	誓う、ののしる
sweet	甘い
swim	泳ぐ
symbol	象徴
sympathy	同情
system	システム
table	机
tail	尾
take	取る
talk	話す
tall	高い
target	標的
task	仕事、役割
taste	味
tax	税金
tea	茶
teach	教える
team	チーム
tear	破る
tear	涙
tell	伝える
term	期間、条件
terrible	ひどい
teritory	領土
terror	恐怖
test	試験
than	（〜）よりも
thank	感謝する
that	それ、あれ
the	
theater	劇場
their	彼らの
theirs	彼らのもの
them	彼らに
then	そのとき、それから
theory	理論
there	そこに、そこで
these	これら
they	彼ら
thick	厚い、太い
thin	薄い、細い
thing	物
think	考える
third	３番目
this	これ
those	それら
though	（〜だ）けれども
thought	思考
threaten	脅す
through	（〜を）通して
throw	投げる
thus	だから
tie	結ぶ
tight	きつい
time	時間
tin	錫（すず）
tiny	とても小さい
tire	疲れさせる
title	タイトル
to	へ、に
today	今日
together	一緒に
tomorrow	明日
tone	音、語調
tongue	舌
tonight	今夜
too	（〜）も
tool	道具
tooth	歯
top	最高の
total	全部
touch	触る
toward	（〜の）ほうへ
town	町
track	小道、走路
trade	貿易
tradition	伝統
traffic	交通
train	電車
transport	運送
travel	旅行する
treason	反逆（罪）
treasure	宝
treat	扱う、治す
treaty	条約
tree	木
trail	裁判、試用
tribe	部族
trick	ごまかす
trip	旅
troop	軍隊、集まり
trouble	困難
truck	トラック／運ぶ
true	真実の
trust	信用する
try	試みる
tube	管、筒
turn	回す、向ける
twice	２度
under	下に
understand	わかる
unit	単位
universe	宇宙
unless	（〜）でないかぎり
until	（〜）まで
up	上
upon	=on
urge	駆り立てる
us	私たち
use	用いる
valley	谷
value	価値
vary	変更する
vegetable	野菜
vehicle	乗り物
version	版
very	非常に
veto	拒否する
vicious	邪悪な
victim	被害者
victory	勝利
view	意見、景色
violence	暴力
visit	訪問する
voice	声
volume	量
vote	投票
wage	給料
wait	待つ
walk	歩く
wall	壁
want	欲しい
war	戦争
warm	温かい
warn	警告する
wash	洗う
waste	浪費する
watch	監視する
water	水
wave	波
way	道
we	私たち
weak	弱い、薄い
wealth	富
weapon	武器
wear	着る
weather	天気
week	週
weight	重さ
welcome	歓迎する
well	井戸
west	西
wet	ぬれた
what	何
wheat	小麦
wheel	輪
when	いつ
where	どこ
whether	（〜）かどうか
which	どちらの
while	しばらく／間
white	白い
who	誰
whole	全体
why	なぜ
wide	広い
wife	妻
wild	野生の
will	（〜）だろう／意志
win	勝つ
wind	風
window	窓
wine	ワイン
wing	翼
winter	冬
wire	針金
wise	賢い
wish	願う
with	（〜）と
withdraw	退く
without	（〜）なしに
woman	女
wonder	不思議に思う
wood	木材
wool	羊毛
word	単語
work	仕事をする
world	世界
worry	心配する
worse	より悪い
worth	価値がある
wound	傷
wreck	破壊する
write	書く
wrong	誤った
yard	ヤード
year	年
yellow	黄色
yes	はい
yesterday	昨日
yet	まだ
you	あなた
young	若い